11111111111111111111111111
12001000300000010000000131
10300100000200001000000101
10000000000000000000300001
11111111111111111000000001
13000000000000000000000301
11111111111111111111111111
