11111111111111111111111111111
10000000000000000000000000001
10101311101010111010111110111
10100000000000000000001020111
10101010101013101010111013111
10100000003000030000110030101
10101311101010111012101010111
10000000000000300000001000031
10101010101010101010101010111
10000000030000000003001010001
13101013101010101010101010101
10000000000000000013000000001
11101110101010111011101110111
10000000000000300000000003011
11111111111111111111111111111