11111111111111111111111111111
11020000001000030000003000101
10111010101010111111101010111
10000000300000003000000030001
12101010101010131010101010101
10000000001010001000000000001
13101010101313101010101110101
10000000000000000000000030001
10101010111010101010101110101
10000030000000000300000010001
10101010111011101310111010101
10000010100030000000000000001
10101010101010101010111010101
13000000001003000000000000011
11111111111111111111111111111