11111111111111111111111111111
10103011100000000011100000001
10101011101011131010101011111
10100003000000000000300000001
10101010101010101010101010101
10100000000010000000000000101
10101010101010111010101010131
10020030000200000030000010001
13101010101010111010101010101
10100000003000000000000003101
10111013111010101310101011101
10000003000000000000000003001
10111010101110101010101011101
10000030000000300000001000001
11111111111111111111111111111