11111111111111111111111111
10001000000000010000000101
10000100000000001000000101
10000000000000000000000001
11111111111111111000000001
10000000000000000000000001
11111111111111111111111111
