11111111111111111111111111111
11100000000000303003000010001
11101010101011101110101110101
11100000000000000000001000001
10101010101010101010101010121
10300000330000000000000010001
10131010101010101310101010101
10000300000000000000130003001
10101011101010101010101010101
10030000000000000000002003131
11101010101011101010101010101
11100003300000000000000000001
11101010111010101010111010101
10000000000000000000000000001
11111111111111111111111111111