11111111111111111111111111111
10000000000000000300030000011
11101011101110101011101110111
10000000000000000000000010101
10101311101010101010101212101
10101000003000003000000000131
10101011111010101010101010101
13000000000000000000100000101
10101311101010101010101010101
10030000000330000030300000301
10111011101010101010131011101
10000000000000000000000000001
10111010111113101011111010101
10000000100000000000000000001
11111111111111111111111111111