11111111111111111111111111
12001000300000010000000101
10000100000200001000000101
10000000000000000000000001
11111111111111111000000001
10000000000000000000000001
11111111111111111111111111
